[TILES]

1=wall
N=player
0=floor

[TEXTURES]

invalid=./textures/invalid.xpm

[COLORS]

[MAP]

111111111111111111111
100000000000000000001
101111111001111111101
101     1001      101
101     1001      101
101     1001      101
101     1001      101
101     1001      101
101     1001      101
101     1001      101
101111111001111111101
100000000N00000000001
111111111111111111111
