[TILES]

1=wall
N=player
0=floor
2=wall

[TEXTURES]

1:N=./textures/north.xpm
1:S=./textures/south.xpm
1:E=./textures/east.xpm
1:W=./textures/west.xpm

invalid=./textures/invalid.xpm

[COLORS]

ceiling=0,255,0
floor=255,255,0

[MAP]

111111111111111111111111111111111111111111111111111
100000000000000000000000000000000000000000000000001
101111111111111111111111101111111111111111111111101
101000000000000000000000000000000000000000000001101
101011111111111111111111101111111111111111111101101
101010000000000000000000000000000000000000000101101
101010111111111111111111101111111111111111110101101
101010100000000000000000000000000000000000010101101
101010101111111111111111101111111111111111010101101
101010101000000000000000000000000000000001010101101
101010101011111111111111101111111111111101010101101
101010101010000000000000000000000000000101010101101
101010101010111111111111101111111111110101010101101
101010101010100000000000000000000000010101010101101
101010101010101111111111101111111111010101010101101
101010101010101000000000000000000001010101010101101
101010101010101011111111101111111101010101010101101
101010101010101010000000000000000101010101010101101
101010101010101010111111101111110101010101010101101
101010101010101010100000000000010101010101010101101
101010101010101010101111101111010101010101010101101
101010101010101010101000000001010101010101010101101
101010101010101010101011101101010101010101010101101
101010101010101010101010000101010101010101010101101
101010101010101010101010100101010101010101010101101
101010101010101010101010N00101010101010101010101101
101010101010101010101010100101010101010101010101101
101010101010101010101010000101010101010101010101101
101010101010101010101011101101010101010101010101101
101010101010101010101000000001010101010101010101101
101010101010101010101111101111010101010101010101101
101010101010101010100000000000010101010101010101101
101010101010101010111111101111110101010101010101101
101010101010101010000000000000000101010101010101101
101010101010101011111111101111111101010101010101101
101010101010101000000000000000000001010101010101101
101010101010101111111111101111111111010101010101101
101010101010100000000000000000000000010101010101101
101010101010111111111111101111111111110101010101101
101010101010000000000000000000000000000101010101101
101010101011111111111111101111111111111101010101101
101010101000000000000000000000000000000001010101101
101010101111111111111111101111111111111111010101101
101010100000000000000000000000000000000000010101101
101010111111111111111111101111111111111111110101101
101010000000000000000000000000000000000000000101101
101011111111111111111111101111111111111111111101101
101000000000000000000000000000000000000000000001101
101111111111111111111111101111111111111111111111101
100000000000000000000000000000000000000000000000001
111111111111111111111111111111111111111111111111111
